手-ヲ-出す	手-ヲ-引く	反義	属性反義
記録-ヲ-持つ	記録-ガ-無い	反義	属性反義
記録-ガ-残る	記録-ガ-無い	反義	属性反義
記録-ヲ-出す	記録-ガ-無い	反義	属性反義
理由-デ-受ける	理由-デ-断る	反義	属性反義
状況-ガ-悪化	状況-ヲ-改善	反義	属性反義
例-ガ-存在	例-ガ-無い	反義	属性反義
気-ガ-強い	気-ガ-弱い	反義	属性反義
点-デ-優れる	点-デ-劣る	反義	属性反義
点-ヲ-除く	点-ヲ-考慮	反義	属性反義
シーン-ガ-存在	シーン-ガ-無い	反義	属性反義
体-ガ-大きい	体-ガ-小さい	反義	属性反義
体-ヲ-鍛える	体-ヲ-壊す	反義	属性反義
政府-ヲ-支持	政府-ヲ-批判	反義	属性反義
政府-ニ-与する	政府-ヲ-批判	反義	属性反義
行為-ヲ-働く	行為-ヲ-非難	反義	属性反義
評価-ガ-高い	評価-ガ-低い	反義	属性反義
評価-ヲ-上げる	評価-ヲ-下げる	反義	属性反義
データ-ヲ-収集	データ-ヲ-提供	反義	属性反義
要素-ヲ-加える	要素-ヲ-排除	反義	属性反義
要素-ガ-存在	要素-ガ-無い	反義	属性反義
距離-ガ-短い	距離-ガ-長い	反義	属性反義
距離-ヲ-縮める	距離-ガ-離れる	反義	属性反義
距離-ガ-近い	距離-ガ-遠い	反義	属性反義
被害-ガ-多い	被害-ガ-少ない	反義	属性反義
被害-ニ-あう	被害-ヲ-免れる	反義	属性反義
説-ヲ-支持	説-ヲ-否定	反義	属性反義
途中-デ-降板	途中-カラ-出場	反義	属性反義
命令-ヲ-受ける	命令-ヲ-拒否	反義	属性反義
命令-ニ-従う	命令-ニ-背く	反義	属性反義
建設-ヲ-推進	建設-ニ-反対	反義	属性反義
主義-ニ-反対	主義-ヲ-支持	反義	属性反義
プレーヤー-ニ-与える	プレーヤー-カラ-奪う	反義	属性反義
ネタ-ヲ-投稿	ネタ-ヲ-募集	反義	属性反義
色-ガ-濃い	色-ガ-薄い	反義	属性反義
スタイル-ヲ-踏襲	スタイル-ヲ-変える	反義	属性反義
基準-ヲ-満たす	基準-ニ-満たない	反義	属性反義
英語-ガ-苦手だ	英語-ガ-得意だ	反義	属性反義
イメージ-ヲ-与える	イメージ-ヲ-払拭	反義	属性反義
イメージ-ヲ-踏襲	イメージ-ヲ-変える	反義	属性反義
金-ヲ-使う	金-ヲ-貯める	反義	属性反義
資格-ヲ-取得	資格-ヲ-喪失	反義	属性反義
資格-ヲ-有す	資格-ヲ-失う	反義	属性反義
漫画-ヲ-読む	漫画-ヲ-書く	反義	属性反義
漫画-ヲ-読む	漫画-ヲ-執筆	反義	属性反義
漫画-ヲ-読む	漫画-ヲ-描く	反義	属性反義
改正-デ-登場	改正-デ-消滅	反義	属性反義
スタッフ-ヲ-集める	スタッフ-ヲ-派遣	反義	属性反義
物語-ヲ-書く	物語-ヲ-読む	反義	属性反義
エリア-ガ-狭い	エリア-ガ-広い	反義	属性反義
演奏-ヲ-披露	演奏-ヲ-見る	反義	属性反義
演奏-ヲ-行う	演奏-ヲ-聴く	反義	属性反義
意識-ガ-高い	意識-ガ-低い	反義	属性反義
意識-ガ-無い	意識-ヲ-持つ	反義	属性反義
ルール-ニ-従う	ルール-ヲ-破る	反義	属性反義
ルール-ヲ-守る	ルール-ニ-違反	反義	属性反義
運営-ニ-協力	運営-カラ-撤退	反義	属性反義
中-ニ-いる	中-ニ-無い	反義	属性反義
ライン-ヲ-超える	ライン-ヲ-守る	反義	属性反義
ライン-ヲ-消す	ライン-ヲ-入れる	反義	属性反義
母親-ヲ-失う	母親-ガ-いる	反義	属性反義
投票-デ-当選	投票-デ-敗れる	反義	属性反義
規定-ガ-無い	規定-ガ-存在	反義	属性反義
人口-ガ-多い	人口-ガ-少ない	反義	属性反義
人口-ガ-増加	人口-ガ-減少	反義	属性反義
高さ-ガ-低い	高さ-ガ-高い	反義	属性反義
高さ-ヲ-下げる	高さ-ヲ-上げる	反義	属性反義
信号-ヲ-出力	信号-ヲ-入力	反義	属性反義
レギュラー-ニ-昇格	レギュラー-ヲ-降板	反義	属性反義
報告-ヲ-行う	報告-ヲ-怠る	反義	属性反義
空港-ヲ-離陸	空港-ニ-着陸	反義	属性反義
パターン-ガ-変化	パターン-ガ-定着	反義	属性反義
パターン-ガ-変わる	パターン-ガ-定着	反義	属性反義
太陽-ニ-近い	太陽-カラ-遠い	反義	属性反義
太陽-ニ-接近	太陽-カラ-離れる	反義	属性反義
手術-ヲ-受ける	手術-ヲ-拒否	反義	属性反義
手術-ニ-成功	手術-ニ-失敗	反義	属性反義
木-ニ-登る	木-カラ-おりる	反義	属性反義
集落-ヲ-作る	集落-ヲ-破壊	反義	属性反義
先端-ガ-白い	先端-ガ-黒い	反義	属性反義
先端-ガ-尖る	先端-ガ-丸い	反義	属性反義
検査-ニ-合格	検査-ニ-引っ掛かる	反義	属性反義
ホテル-デ-働く	ホテル-ヲ-経営	反義	属性反義
定義-ガ-存在	定義-ガ-無い	反義	属性反義
文献-ガ-存在	文献-ガ-無い	反義	属性反義
抵抗-ガ-大きい	抵抗-ガ-小さい	反義	属性反義
抵抗-ヲ-示す	抵抗-ガ-無い	反義	属性反義
費用-ガ-高い	費用-ガ-安い	反義	属性反義
費用-ガ-嵩む	費用-ヲ-抑える	反義	属性反義
銀行-ト-合併	銀行-ヲ-買収	反義	属性反義
箇所-ガ-多い	箇所-ガ-少ない	反義	属性反義
箇所-ガ-存在	箇所-ガ-無い	反義	属性反義
間隔-ガ-狭い	間隔-ガ-広い	反義	属性反義
間隔-ガ-長い	間隔-ガ-短い	反義	属性反義
胸-ガ-大きい	胸-ガ-小さい	反義	属性反義
駅前-ニ-存在	駅前-ニ-無い	反義	属性反義
課題-ヲ-残す	課題-ヲ-解決	反義	属性反義
課題-ガ-残る	課題-ヲ-克服	反義	属性反義
伝統-ヲ-守る	伝統-ヲ-破る	反義	属性反義
指名-ヲ-受ける	指名-ヲ-拒否	反義	属性反義
指名-ヲ-受諾	指名-ヲ-辞退	反義	属性反義
指名-ヲ-受諾	指名-ヲ-断る	反義	属性反義
学者-ニ-与える	学者-カラ-受ける	反義	属性反義
猫-ガ-好きだ	猫-ガ-苦手だ	反義	属性反義
猫-ヲ-殺す	猫-ヲ-助ける	反義	属性反義
猫-ガ-いる	猫-ヲ-探す	反義	属性反義
義務-ヲ-果たす	義務-ヲ-怠る	反義	属性反義
意向-ニ-反す	意向-ニ-従う	反義	属性反義
涙-ヲ-流す	涙-ヲ-こらえる	反義	属性反義
涙-ヲ-見せる	涙-ヲ-飲む	反義	属性反義
パフォーマンス-ガ-悪い	パフォーマンス-ガ-高い	反義	属性反義
スタート-ヲ-決める	スタート-ニ-失敗	反義	属性反義
スタート-デ-出遅れる	スタート-カラ-逃げる	反義	属性反義
ＩＣ-カラ-入る	ＩＣ-デ-降りる	反義	属性反義
ＩＣ-カラ-入る	ＩＣ-ヲ-出る	反義	属性反義
駒-ガ-存在	駒-ガ-無い	反義	属性反義
乱-ヲ-起こす	乱-ヲ-鎮圧	反義	属性反義
信頼-ニ-応える	信頼-ヲ-裏切る	反義	属性反義
病-ヲ-おす	病-ヲ-理由	反義	属性反義
業績-ガ-悪化	業績-ヲ-拡大	反義	属性反義
必要性-ガ-高まる	必要性-ガ-薄れる	反義	属性反義
必要性-ガ-生ずる	必要性-ガ-なくなる	反義	属性反義
長さ-ガ-短い	長さ-ガ-長い	反義	属性反義
長さ-ガ-短いなる	長さ-ガ-長いなる	反義	属性反義
構内-ニ-存在	構内-ニ-無い	反義	属性反義
構内-ニ-残る	構内-ニ-無い	反義	属性反義
量-ガ-多い	量-ガ-少ない	反義	属性反義
量-ガ-増加	量-ガ-減少	反義	属性反義
量-ガ-多いなる	量-ガ-少ないなる	反義	属性反義
パートナー-ヲ-得る	パートナー-ヲ-失う	反義	属性反義
火災-ヲ-防ぐ	火災-ヲ-起こす	反義	属性反義
発行-ヲ-開始	発行-ヲ-停止	反義	属性反義
発行-ヲ-継続	発行-ヲ-終了	反義	属性反義
リリース-ガ-続く	リリース-ガ-途絶える	反義	属性反義
自殺-ヲ-止める	自殺-ニ-至る	反義	属性反義
回復-ガ-遅れる	回復-ガ-早い	反義	属性反義
体力-ガ-高い	体力-ガ-低い	反義	属性反義
体力-ヲ-減らす	体力-ヲ-つける	反義	属性反義
体力-ガ-無い	体力-ヲ-持つ	反義	属性反義
停留所-ガ-無い	停留所-ガ-存在	反義	属性反義
停留所-デ-下車	停留所-デ-乗る	反義	属性反義
事項-ヲ-含む	事項-ヲ-除く	反義	属性反義
崩壊-ヲ-起こす	崩壊-ヲ-防ぐ	反義	属性反義
制覇-ヲ-果たす	制覇-ヲ-逃す	反義	属性反義
再建-ヲ-断念	再建-ヲ-果たす	反義	属性反義
再建-ヲ-断念	再建-ニ-成功	反義	属性反義
癖-ガ-強い	癖-ガ-少ない	反義	属性反義
癖-ヲ-持つ	癖-ガ-無い	反義	属性反義
例外-ヲ-除く	例外-ヲ-含む	反義	属性反義
射撃-ヲ-浴びせる	射撃-ヲ-浴びる	反義	属性反義
大陸-ニ-渡る	大陸-カラ-離れる	反義	属性反義
大陸-ニ-渡る	大陸-カラ-伝来	反義	属性反義
法則-ニ-従う	法則-ニ-反する	反義	属性反義
法則-ニ-従う	法則-ヲ-無視	反義	属性反義
意図-ニ-反す	意図-ヲ-汲む	反義	属性反義
意図-ガ-無い	意図-ヲ-含む	反義	属性反義
乗客-ガ-多い	乗客-ガ-少ない	反義	属性反義
乗客-ガ-減少	乗客-ガ-増加	反義	属性反義
科学-ヲ-捨てる	科学-ヲ-使う	反義	属性反義
急行-ガ-停車	急行-ガ-通過	反義	属性反義
序盤-カラ-好調だ	序盤-カラ-低迷	反義	属性反義
好評-ト-言い難い	好評-ト-言う	反義	属性反義
表情-ニ-乏しい	表情-ガ-豊かだ	反義	属性反義
レンズ-ヲ-使用	レンズ-ヲ-供給	反義	属性反義
レンズ-ヲ-作る	レンズ-ヲ-使う	反義	属性反義
レンズ-ヲ-使用	レンズ-ヲ-製造	反義	属性反義
便-ガ-良い	便-ガ-悪い	反義	属性反義
タイミング-ヲ-合わせる	タイミング-ヲ-ずらす	反義	属性反義
タイミング-ガ-早い	タイミング-ガ-遅い	反義	属性反義
タイミング-ヲ-見極める	タイミング-ヲ-誤る	反義	属性反義
人質-ヲ-殺害	人質-ヲ-解放	反義	属性反義
人質-ヲ-殺す	人質-ヲ-助ける	反義	属性反義
適用-ヲ-受ける	適用-ヲ-免れる	反義	属性反義
適用-ガ-可能だ	適用-ガ-困難だ	反義	属性反義
濃度-ガ-高い	濃度-ガ-低い	反義	属性反義
濃度-ガ-上昇	濃度-ガ-低下	反義	属性反義
濃度-ヲ-上げる	濃度-ヲ-下げる	反義	属性反義
弱点-ガ-無い	弱点-ガ-存在	反義	属性反義
弱点-ヲ-カバー	弱点-ガ-露呈	反義	属性反義
推薦-ヲ-受ける	推薦-ヲ-辞退	反義	属性反義
復讐-ヲ-忘れる	復讐-ヲ-行う	反義	属性反義
領地-ヲ-得る	領地-ヲ-失う	反義	属性反義
プロダクション-ニ-所属	プロダクション-カラ-独立	反義	属性反義
代-カラ-続く	代-デ-絶える	反義	属性反義
分子-ト-結合	分子-ヲ-分離	反義	属性反義
周波数-ガ-高い	周波数-ガ-低い	反義	属性反義
周波数-ヲ-変える	周波数-ヲ-合わせる	反義	属性反義
踏切-ガ-存在	踏切-ガ-無い	反義	属性反義
踏切-ヲ-利用	踏切-ヲ-廃止	反義	属性反義
羽根-ヲ-持つ	羽根-ガ-無い	反義	属性反義
水面-カラ-高い	水面-カラ-低い	反義	属性反義
水面-ニ-浮く	水面-ニ-沈む	反義	属性反義
権威-ヲ-高める	権威-ガ-低下	反義	属性反義
挨拶-ヲ-行う	挨拶-ガ-無い	反義	属性反義
挨拶-カラ-始まる	挨拶-デ-締める	反義	属性反義
借金-ヲ-踏み倒す	借金-ヲ-返す	反義	属性反義
カーブ-ガ-多い	カーブ-ガ-少ない	反義	属性反義
本数-ガ-少ない	本数-ガ-多い	反義	属性反義
本数-ガ-増加	本数-ガ-減少	反義	属性反義
本数-ガ-多いなる	本数-ガ-少ないなる	反義	属性反義
株-ヲ-上げる	株-ヲ-奪う	反義	属性反義
共演-ガ-多い	共演-ガ-無い	反義	属性反義
調子-ヲ-上げる	調子-ガ-落ちる	反義	属性反義
調子-ガ-悪い	調子-ガ-良い	反義	属性反義
調子-ヲ-整える	調子-ヲ-崩す	反義	属性反義
防御-ガ-低い	防御-ガ-高い	反義	属性反義
レーダー-デ-発見	レーダー-カラ-消失	反義	属性反義
法案-ニ-反対	法案-ニ-賛成	反義	属性反義
パンチ-ヲ-受ける	パンチ-ヲ-かわす	反義	属性反義
占領-ニ-成功	占領-ニ-失敗	反義	属性反義
サイン-ニ-応じる	サイン-ヲ-拒否	反義	属性反義
サイン-ヲ-見る	サイン-ヲ-見逃す	反義	属性反義
難-ニ-あう	難-ヲ-逃れる	反義	属性反義
難-ニ-会う	難-ヲ-避ける	反義	属性反義
難-ニ-会う	難-ヲ-免れる	反義	属性反義
ワイン-ヲ-生産	ワイン-ヲ-使う	反義	属性反義
ワイン-ヲ-産する	ワイン-ヲ-飲む	反義	属性反義
互換性-ガ-高い	互換性-ガ-低い	反義	属性反義
互換性-ガ-無い	互換性-ヲ-有す	反義	属性反義
接触-ヲ-続ける	接触-ヲ-断つ	反義	属性反義
合成-ヲ-促進	合成-ヲ-抑制	反義	属性反義
尾-ガ-長い	尾-ガ-短い	反義	属性反義
尾-ガ-太い	尾-ガ-細い	反義	属性反義
尾-ヲ-持つ	尾-ガ-無い	反義	属性反義
個性-ヲ-持つ	個性-ガ-無い	反義	属性反義
個性-ガ-強い	個性-ガ-無い	反義	属性反義
名所-ガ-点在	名所-ガ-集中	反義	属性反義
問題点-ガ-多い	問題点-ガ-無い	反義	属性反義
出番-ガ-多い	出番-ガ-少ない	反義	属性反義
出番-ガ-増える	出番-ガ-減る	反義	属性反義
出番-ガ-多いなる	出番-ガ-少ないなる	反義	属性反義
回答-ヲ-出す	回答-ガ-無い	反義	属性反義
恋愛-ニ-積極的だ	恋愛-ニ-臆病だ	反義	属性反義
署名-ヲ-行う	署名-ヲ-拒む	反義	属性反義
署名-ヲ-得る	署名-ガ-無い	反義	属性反義
署名-ヲ-得る	署名-ヲ-求める	反義	属性反義
砲弾-ヲ-消費	砲弾-ヲ-作る	反義	属性反義
攻略-ニ-成功	攻略-ニ-失敗	反義	属性反義
谷-ヲ-埋める	谷-ヲ-刻む	反義	属性反義
谷-ヲ-埋める	谷-ヲ-作る	反義	属性反義
呪文-ヲ-放つ	呪文-ヲ-封ずる	反義	属性反義
呪文-ヲ-受ける	呪文-ヲ-跳ね返す	反義	属性反義
近辺-ニ-存在	近辺-ニ-無い	反義	属性反義
間-ガ-開く	間-ガ-無い	反義	属性反義
間-ヲ-空ける	間-ガ-無い	反義	属性反義
砦-ヲ-守る	砦-ヲ-放棄	反義	属性反義
信頼性-ガ-高い	信頼性-ガ-低い	反義	属性反義
信頼性-ヲ-損なう	信頼性-ヲ-得る	反義	属性反義
信頼性-ガ-低下	信頼性-ガ-向上	反義	属性反義
介入-ヲ-求める	介入-ヲ-拒否	反義	属性反義
介入-ヲ-支持	介入-ニ-反対	反義	属性反義
会談-ニ-応じる	会談-ヲ-拒否	反義	属性反義
理想-ニ-近い	理想-ト-掛け離れる	反義	属性反義
農民-ヲ-苦しめる	農民-ヲ-救う	反義	属性反義
反響-ヲ-得る	反響-ガ-無い	反義	属性反義
非難-ヲ-受ける	非難-ヲ-かわす	反義	属性反義
非難-ヲ-受ける	非難-ヲ-避ける	反義	属性反義
食料-ヲ-持つ	食料-ガ-尽きる	反義	属性反義
特権-ヲ-獲得	特権-ヲ-放棄	反義	属性反義
特権-ヲ-得る	特権-ヲ-失う	反義	属性反義
グラウンド-ガ-狭い	グラウンド-ガ-広い	反義	属性反義
蓋-ガ-つく	蓋-ガ-無い	反義	属性反義
測定-ニ-適す	測定-ガ-難しい	反義	属性反義
測定-ガ-行える	測定-ガ-困難だ	反義	属性反義
測定-ガ-可能になる	測定-ガ-困難だ	反義	属性反義
海底-ニ-沈める	海底-カラ-引き上げる	反義	属性反義
法令-ニ-従う	法令-ニ-違反	反義	属性反義
法令-ヲ-無視	法令-ニ-従う	反義	属性反義
品質-ガ-良い	品質-ガ-悪い	反義	属性反義
品質-ガ-向上	品質-ガ-劣化	反義	属性反義
突起-ガ-存在	突起-ガ-無い	反義	属性反義
ランク-ガ-上がる	ランク-ガ-下がる	反義	属性反義
ランク-ヲ-上げる	ランク-ヲ-下げる	反義	属性反義
ランク-ガ-高い	ランク-ガ-低い	反義	属性反義
インディアン-カラ-奪う	インディアン-ニ-与える	反義	属性反義
線上-ニ-存在	線上-ニ-無い	反義	属性反義
線上-ニ-位置	線上-ニ-無い	反義	属性反義
線上-ニ-いる	線上-ニ-無い	反義	属性反義
単体-デ-無い	単体-デ-存在	反義	属性反義
勇気-ガ-無い	勇気-ヲ-持つ	反義	属性反義
送信-ヲ-禁止	送信-ヲ-認める	反義	属性反義
列-ヲ-成す	列-ヲ-乱す	反義	属性反義
県道-ニ-降格	県道-ニ-昇格	反義	属性反義
頼朝-ニ-協力	頼朝-ト-対立	反義	属性反義
滑走路-ニ-着陸	滑走路-カラ-離陸	反義	属性反義
滑走路-ヲ-逸脱	滑走路-ニ-進入	反義	属性反義
老人-ヲ-助ける	老人-ヲ-殺す	反義	属性反義
稽古-ヲ-受ける	稽古-ヲ-休む	反義	属性反義
グラフィック-ヲ-持つ	グラフィック-ガ-無い	反義	属性反義
グラフィック-ヲ-用いる	グラフィック-ガ-無い	反義	属性反義
人員-ガ-多い	人員-ガ-少ない	反義	属性反義
人員-ヲ-確保	人員-ヲ-削減	反義	属性反義
一揆-ヲ-起こす	一揆-ヲ-鎮圧	反義	属性反義
一揆-ニ-加担	一揆-ト-戦う	反義	属性反義
執行-ガ-無い	執行-ヲ-行う	反義	属性反義
執行-ヲ-受ける	執行-ヲ-免れる	反義	属性反義
因子-ガ-存在	因子-ガ-無い	反義	属性反義
因子-ヲ-活性化	因子-ガ-低下	反義	属性反義
賠償-ヲ-受ける	賠償-ヲ-放棄	反義	属性反義
君主-ガ-支配	君主-ニ-仕える	反義	属性反義
素顔-ヲ-隠す	素顔-ヲ-見せる	反義	属性反義
素顔-ヲ-隠す	素顔-ヲ-暴く	反義	属性反義
昇進-ガ-早い	昇進-ガ-遅い	反義	属性反義
ステッカー-ヲ-掲示	ステッカー-ヲ-剥がす	反義	属性反義
処刑-ヲ-免れる	処刑-ガ-決まる	反義	属性反義
勧告-ヲ-受諾	勧告-ヲ-拒絶	反義	属性反義
セーブ-ヲ-達成	セーブ-ニ-失敗	反義	属性反義
ＤＮＡ-ヲ-合成	ＤＮＡ-ヲ-切断	反義	属性反義
和解-ヲ-求める	和解-ニ-応じる	反義	属性反義
和解-ヲ-申し入れる	和解-ヲ-申し出る	反義	属性反義
和解-ガ-成立	和解-ヲ-拒否	反義	属性反義
書簡-ヲ-書く	書簡-ヲ-読む	反義	属性反義
主権-ヲ-持つ	主権-ヲ-失う	反義	属性反義
主権-ヲ-尊重	主権-ヲ-侵害	反義	属性反義
待遇-ガ-良い	待遇-ガ-悪い	反義	属性反義
待遇-ヲ-廃止	待遇-ヲ-定める	反義	属性反義
火事-ヲ-引き起こす	火事-ヲ-消す	反義	属性反義
操縦-ガ-困難だ	操縦-ガ-容易だ	反義	属性反義
暴行-ヲ-阻止	暴行-ヲ-起こす	反義	属性反義
高温-ニ-弱い	高温-ニ-強い	反義	属性反義
回収-ニ-成功	回収-ニ-失敗	反義	属性反義
肩書き-ヲ-持つ	肩書き-ガ-無い	反義	属性反義
虫-ガ-好きだ	虫-ガ-苦手だ	反義	属性反義
虫-ガ-大好きだ	虫-ガ-大嫌いだ	反義	属性反義
素子-ヲ-製造	素子-ヲ-破壊	反義	属性反義
水域-ニ-向かう	水域-ヲ-離れる	反義	属性反義
農地-ヲ-失う	農地-ヲ-持つ	反義	属性反義
農地-ヲ-失う	農地-ヲ-所有	反義	属性反義
農地-ヲ-失う	農地-ヲ-抱える	反義	属性反義
大差-ガ-付く	大差-ガ-無い	反義	属性反義
パラメータ-ガ-低い	パラメータ-ガ-高い	反義	属性反義
発想-ヲ-得る	発想-ガ-無い	反義	属性反義
民家-ガ-多い	民家-ガ-少ない	反義	属性反義
民家-ガ-密集	民家-ガ-散在	反義	属性反義
検索-ニ-失敗	検索-ヲ-実現	反義	属性反義
態勢-ガ-整う	態勢-ガ-不十分だ	反義	属性反義
変形-ヲ-繰り返す	変形-ガ-少ない	反義	属性反義
変形-ヲ-起こす	変形-ヲ-防ぐ	反義	属性反義
滅亡-ヲ-防ぐ	滅亡-ニ-追い遣る	反義	属性反義
滅亡-カラ-救う	滅亡-ニ-導く	反義	属性反義
滅亡-ヲ-免れる	滅亡-ヲ-迎える	反義	属性反義
支持者-ヲ-得る	支持者-ヲ-失う	反義	属性反義
支持者-カラ-受ける	支持者-ニ-与える	反義	属性反義
毒性-ガ-低い	毒性-ガ-高い	反義	属性反義
毒性-ヲ-有する	毒性-ガ-無い	反義	属性反義
毒性-ガ-弱い	毒性-ガ-強い	反義	属性反義
口座-ニ-振り込む	口座-カラ-引き出す	反義	属性反義
丸み-ヲ-つける	丸み-ヲ-とる	反義	属性反義
丸み-ガ-大きい	丸み-ガ-小さい	反義	属性反義
丸み-ヲ-廃す	丸み-ガ-増す	反義	属性反義
風習-ガ-存在	風習-ガ-無い	反義	属性反義
支流-ガ-合流	支流-ニ-分かれる	反義	属性反義
予測-ヲ-上回る	予測-ヲ-下回る	反義	属性反義
東口-ニ-存在	東口-ニ-無い	反義	属性反義
東口-ヲ-出る	東口-ニ-至る	反義	属性反義
唐-ヲ-滅ぼす	唐-ニ-敗れる	反義	属性反義
唐-ニ-属す	唐-ト-対立	反義	属性反義
苦痛-カラ-逃れる	苦痛-ニ-耐える	反義	属性反義
苦痛-ヲ-もたらす	苦痛-ヲ-取り除く	反義	属性反義
家屋-ガ-密集	家屋-ガ-点在	反義	属性反義
漁業-ガ-発展	漁業-ガ-衰退	反義	属性反義
爵位-ヲ-受ける	爵位-ヲ-返上	反義	属性反義
樹木-ヲ-植栽	樹木-ヲ-切る	反義	属性反義
樹木-ガ-多い	樹木-ガ-少ない	反義	属性反義
樹木-ヲ-植栽	樹木-ヲ-伐採	反義	属性反義
エラー-ガ-起こる	エラー-ガ-無い	反義	属性反義
エラー-ガ-発生	エラー-ヲ-回避	反義	属性反義
体育館-ヲ-備える	体育館-ガ-無い	反義	属性反義
破壊力-ヲ-発揮	破壊力-ヲ-秘める	反義	属性反義
構造物-ヲ-撤去	構造物-ガ-残る	反義	属性反義
入れ墨-ヲ-持つ	入れ墨-ガ-無い	反義	属性反義
入れ墨-ヲ-隠す	入れ墨-ヲ-見せる	反義	属性反義
入れ墨-ヲ-消す	入れ墨-ヲ-彫る	反義	属性反義
パンツ-ヲ-履く	パンツ-ヲ-脱ぐ	反義	属性反義
パンツ-ヲ-はく	パンツ-ヲ-下ろす	反義	属性反義
パンツ-ヲ-着る	パンツ-ヲ-脱ぐ	反義	属性反義
負債-ガ-膨らむ	負債-ヲ-減らす	反義	属性反義
行使-ヲ-認める	行使-ヲ-禁ずる	反義	属性反義
締結-ニ-反対	締結-ヲ-推進	反義	属性反義
連結器-ヲ-装着	連結器-ヲ-撤去	反義	属性反義
連結器-ヲ-取り付ける	連結器-ガ-外れる	反義	属性反義
連結器-ヲ-備える	連結器-ヲ-撤去	反義	属性反義
足跡-ヲ-消す	足跡-ヲ-刻む	反義	属性反義
足跡-ヲ-消す	足跡-ヲ-残す	反義	属性反義
足跡-ヲ-消す	足跡-ヲ-遺す	反義	属性反義
機動力-ガ-高い	機動力-ガ-低い	反義	属性反義
機動力-ガ-向上	機動力-ガ-低下	反義	属性反義
機動力-ニ-優れる	機動力-ニ-欠ける	反義	属性反義
広さ-ヲ-持つ	広さ-ガ-無い	反義	属性反義
広さ-ヲ-有す	広さ-ガ-無い	反義	属性反義
広さ-ヲ-有する	広さ-ガ-無い	反義	属性反義
就職-ヲ-果たす	就職-ニ-失敗	反義	属性反義
策略-ニ-引っ掛かる	策略-ヲ-見抜く	反義	属性反義
助監督-ニ-昇格	助監督-ニ-降格	反義	属性反義
石炭-ヲ-消費	石炭-ヲ-産する	反義	属性反義
石炭-ヲ-消費	石炭-ヲ-産出	反義	属性反義
石炭-ヲ-使う	石炭-ヲ-産する	反義	属性反義
得票-ヲ-減らす	得票-ヲ-増やす	反義	属性反義
得票-ニ-止まる	得票-ヲ-伸ばす	反義	属性反義
謝罪-ヲ-受け入れる	謝罪-ヲ-拒否	反義	属性反義
謝罪-ガ-無い	謝罪-ガ-為される	反義	属性反義
家畜-ヲ-襲う	家畜-ヲ-守る	反義	属性反義
救出-ニ-成功	救出-ニ-失敗	反義	属性反義
採掘-ヲ-中止	採掘-ヲ-再開	反義	属性反義
足場-ヲ-作る	足場-ヲ-破壊	反義	属性反義
足場-ヲ-組む	足場-ヲ-崩す	反義	属性反義
足場-ヲ-築く	足場-ヲ-破壊	反義	属性反義
消息-ガ-判明	消息-ガ-不明だ	反義	属性反義
利用客-ガ-多い	利用客-ガ-少ない	反義	属性反義
利用客-ガ-増加	利用客-ガ-減少	反義	属性反義
利用客-ガ-減る	利用客-ガ-増える	反義	属性反義
オープン-ヲ-欠場	オープン-ニ-出場	反義	属性反義
追跡-ヲ-断念	追跡-ヲ-続ける	反義	属性反義
構図-ガ-出来る	構図-ガ-崩れる	反義	属性反義
協議会-ニ-参加	協議会-カラ-離脱	反義	属性反義
メンテナンス-ガ-必要だ	メンテナンス-ガ-不要だ	反義	属性反義
メンテナンス-ガ-容易だ	メンテナンス-ガ-難しい	反義	属性反義
地球人-ヲ-滅ぼす	地球人-ヲ-救う	反義	属性反義
風味-ガ-増す	風味-ガ-落ちる	反義	属性反義
生態系-ニ-配慮	生態系-ヲ-脅かす	反義	属性反義
生態系-ヲ-破壊	生態系-ヲ-保護	反義	属性反義
代金-ヲ-踏み倒す	代金-ヲ-支払う	反義	属性反義
辞書-ニ-無い	辞書-ニ-載る	反義	属性反義
荷重-ガ-大きい	荷重-ガ-小さい	反義	属性反義
荷重-ヲ-加える	荷重-ヲ-減らす	反義	属性反義
度合い-ガ-小さい	度合い-ガ-大きい	反義	属性反義
度合い-ガ-低い	度合い-ガ-高い	反義	属性反義
吸収-ヲ-阻害	吸収-ヲ-促進	反義	属性反義
吸収-ヲ-抑制	吸収-ヲ-促進	反義	属性反義
吸収-ガ-少ない	吸収-ガ-大きい	反義	属性反義
欄-ヲ-あける	欄-ニ-入れる	反義	属性反義
チャンピオンシップ-ニ-勝利	チャンピオンシップ-ニ-敗退	反義	属性反義
チャンピオンシップ-ニ-勝利	チャンピオンシップ-デ-敗れる	反義	属性反義
チャンピオンシップ-デ-破る	チャンピオンシップ-デ-敗れる	反義	属性反義
フライ-ヲ-捕球	フライ-ヲ-落球	反義	属性反義
血管-ガ-収縮	血管-ガ-拡張	反義	属性反義
聖地-ヲ-守る	聖地-ヲ-襲撃	反義	属性反義
語彙-ガ-多い	語彙-ガ-少ない	反義	属性反義
語彙-ガ-豊富だ	語彙-ガ-少ない	反義	属性反義
傘-ヲ-持つ	傘-ガ-無い	反義	属性反義
妻子-ヲ-残す	妻子-ヲ-連れる	反義	属性反義
立て続け-ニ-失う	立て続け-ニ-獲得	反義	属性反義
雌-ヨリ-小さい	雌-ヨリ-大きい	反義	属性反義
男児-ヲ-無事出産	男児-ヲ-死産	反義	属性反義
男児-ヲ-出産	男児-ヲ-殺す	反義	属性反義
沿岸部-ニ-集中	沿岸部-デ-少ない	反義	属性反義
伝達-ガ-出来る	伝達-ガ-難しい	反義	属性反義
解-ガ-無い	解-ガ-存在	反義	属性反義
指数-ガ-低い	指数-ガ-高い	反義	属性反義
重臣-ト-対立	重臣-ト-協力	反義	属性反義
アジト-ニ-戻る	アジト-カラ-脱出	反義	属性反義
出兵-ヲ-拒否	出兵-ヲ-認める	反義	属性反義
実名-ヲ-公表	実名-ヲ-伏せる	反義	属性反義
重心-ガ-高い	重心-ガ-低い	反義	属性反義
重心-ニ-近い	重心-カラ-離れる	反義	属性反義
体毛-ガ-濃い	体毛-ガ-薄い	反義	属性反義
体毛-ヲ-持つ	体毛-ガ-なく	反義	属性反義
民間人-ヲ-救助	民間人-ヲ-殺す	反義	属性反義
民間人-ヲ-攻撃	民間人-ヲ-守る	反義	属性反義
民間人-ヲ-救助	民間人-ヲ-殺害	反義	属性反義
害-ガ-少ない	害-ガ-多い	反義	属性反義
害-ヲ-成す	害-ガ-無い	反義	属性反義
絵本-ヲ-読む	絵本-ヲ-描く	反義	属性反義
絵本-ヲ-見る	絵本-ヲ-書く	反義	属性反義
絵本-ヲ-作る	絵本-ヲ-読み聞かせる	反義	属性反義
前進-ヲ-続ける	前進-ヲ-止める	反義	属性反義
オチ-ガ-つく	オチ-ガ-無い	反義	属性反義
議決-ニ-加わる	議決-ニ-反対	反義	属性反義
栄養-ガ-豊富だ	栄養-ガ-不足	反義	属性反義
体色-ガ-濃い	体色-ガ-薄い	反義	属性反義
根底-ヲ-支える	根底-カラ-揺さ振る	反義	属性反義
ディフェンス-ガ-弱い	ディフェンス-ガ-得意だ	反義	属性反義
ディフェンス-ガ-弱い	ディフェンス-ニ-優れる	反義	属性反義
交戦-ニ-入る	交戦-ヲ-避ける	反義	属性反義
回転数-ヲ-上げる	回転数-ヲ-下げる	反義	属性反義
回転数-ガ-上がる	回転数-ガ-下がる	反義	属性反義
回転数-ガ-高い	回転数-ガ-低い	反義	属性反義
所在-ガ-不明になる	所在-ガ-明らかになる	反義	属性反義
所在-ヲ-教える	所在-ヲ-隠す	反義	属性反義
税金-ガ-安い	税金-ガ-高い	反義	属性反義
野心-ヲ-見せる	野心-ヲ-隠す	反義	属性反義
野心-ヲ-持つ	野心-ガ-無い	反義	属性反義
家事-ガ-得意だ	家事-ガ-苦手だ	反義	属性反義
